
NO sldkvsdvghdfgv


SO

WE

EA

F

  C
111111111111
10000000N001
10000000N001
10000000N001
10000000N001
10000000N001
10000000N001
10000000N001
10000000N001
11111111111
